100                                                                                                
18
                                                           NFFFFFFFN                             
                                                           W       W                             
                                                           W       W                              
                                                           W       W                               
                                                           W       W                               
                                    N                      W       W                               
                                    W                      W       W                               
                                    W                      W       W                               
                                    W                      W       W                               
                             FFFFFFFFFFFFFF                W       W                               
                                                           NCCCCCCCN                             
                                                                                                   
                                                                                                   
FFFFFFFFFFFFFFFFFFFFFFFFFFFFFFFFFFFFFFFFFFFFFFFFFN    NFFFFFFFFFFFFFFFFFFFFFFFFFFFFFFFFFFFFFFFFFFFF
FFFFFFFFFFFFFFFFFFFFFFFFFFFFFFFFFFFFFFFFFFFFFFFFFW    WFFFFFFFFFFFFFFFFFFFFFFFFFFFFFFFFFFFFFFFFFFFF
FFFFFFFFFFFFFFFFFFFFFFFFFFFFFFFFFFFFFFFFFFFFFFFFFW    WFFFFFFFFFFFFFFFFFFFFFFFFFFFFFFFFFFFFFFFFFFFF
FFFFFFFFFFFFFFFFFFFFFFFFFFFFFFFFFFFFFFFFFFFFFFFFFW    WFFFFFFFFFFFFFFFFFFFFFFFFFFFFFFFFFFFFFFFFFFFF
FFFFFFFFFFFFFFFFFFFFFFFFFFFFFFFFFFFFFFFFFFFFFFFFFW    WFFFFFFFFFFFFFFFFFFFFFFFFFFFFFFFFFFFFFFFFFFFF